{
  "groundTextureUrl": "./assets/textures/ground.jpg",
  "wallTextureUrl": "./assets/textures/wall.jpg",
  "doorTextureUrl": "./assets/textures/ground.jpg",
  "elevatorTextureUrl": "./assets/textures/ground.jpg",
  "size": { "width": 12, "height": 20 },
  "map": [
    [3, 2, 3, 2, 2, 2, 2, 2, 2, 2, 2, 2, 1],
    [1, 0, 6, 0, 0, 0, 0, 0, 0, 0, 0, 0, 1],
    [50, 40, 30, 0, 0, 0, 51, 41, 41, 41, 4, 41, 31],
    [30, 20, 30, 0, 0, 0, 31, 21, 21, 21, 21, 21, 31],
    [30, 20, 5, 0, 0, 0, 31, 21, 21, 21, 21, 21, 31],
    [55, 45, 45, 45, 35, 0, 52, 42, 42, 42, 42, 42, 32],
    [35, 25, 25, 25, 35, 0, 5, 22, 22, 22, 22, 22, 32],
    [35, 25, 25, 25, 35, 0, 32, 22, 22, 22, 22, 22, 32],
    [35, 25, 25, 25, 35, 0, 32, 22, 22, 22, 22, 22, 32],
    [35, 25, 25, 25, 35, 0, 32, 22, 22, 22, 22, 22, 32],
    [35, 25, 25, 25, 5, 0, 32, 22, 22, 22, 22, 22, 32],
    [35, 25, 25, 25, 35, 0, 53, 43, 43, 43, 43, 43, 33],
    [56, 46, 46, 46, 36, 0, 5, 23, 23, 23, 23, 23, 33],
    [36, 26, 26, 26, 36, 0, 33, 23, 23, 23, 23, 23, 33],
    [36, 26, 26, 26, 36, 0, 54, 44, 44, 44, 44, 44, 1],
    [36, 26, 26, 26, 5, 0, 34, 24, 24, 24, 24, 24, 34],
    [36, 26, 26, 26, 36, 0, 34, 24, 24, 24, 24, 24, 34],
    [36, 26, 26, 26, 36, 0, 34, 24, 24, 24, 24, 24, 34],
    [36, 26, 26, 26, 36, 0, 5, 24, 24, 24, 24, 24, 34],
    [36, 26, 26, 26, 36, 0, 34, 24, 24, 24, 24, 24, 34],
    [46, 46, 46, 46, 46, 2, 44, 44, 44, 44, 44, 44, 0]
  ],
  "initialPosition": [1, 3],
  "initialDirection": 0.0,
  "rooms": ["D101", "D102", "D104", "D106", "D108", "D103", "D105"],
  "lift":["Floor D2*file-1701015757155-329601251.json","Floor D3*file-1701015781560-506564442.json"],
  "passages":[]
}
