{
  "groundTextureUrl": "./assets/textures/ground.jpg",
  "wallTextureUrl": "./assets/textures/wall.jpg",
  "doorTextureUrl": "./assets/textures/ground.jpg",
  "elevatorTextureUrl": "./assets/textures/ground.jpg",
  "size": { "width": 12, "height": 20 },
  "map": [
    [50, 40, 40, 40, 50, 41, 41, 41, 41, 41, 41, 41, 31],
    [30, 20, 20, 20, 30, 21, 21, 21, 21, 21, 21, 21, 31],
    [30, 20, 20, 20, 30, 21, 21, 21, 21, 21, 21, 21, 31],
    [30, 20, 20, 20, 30, 21, 21, 21, 21, 21, 21, 21, 31],
    [30, 20, 20, 20, 50, 4, 51, 41, 41, 41, 41, 41, 31],
    [30, 20, 20, 20, 30, 0, 32, 22, 22, 22, 22, 22, 32],
    [30, 20, 20, 20, 5, 0, 5, 22, 22, 22, 22, 22, 32],
    [30, 20, 20, 20, 30, 0, 32, 22, 22, 22, 22, 22, 32],
    [50, 40, 40, 40, 0, 0, 42, 42, 42, 42, 42, 42, 32],
    [8, 0, 0, 0, 0, 0, 0, 0, 0, 0, 0, 0, 1],
    [1, 0, 0, 0, 0, 0, 0, 0, 53, 43, 4, 43, 33],
    [1, 0, 0, 0, 0, 0, 0, 0, 33, 23, 23, 23, 33],
    [3, 2, 1, 0, 0, 0, 0, 0, 53, 43, 43, 43, 33],
    [1, 0, 6, 0, 0, 0, 0, 0, 34, 24, 24, 24, 34],
    [3, 2, 0, 0, 0, 0, 0, 0, 44, 44, 4, 44, 34],
    [9, 0, 0, 0, 0, 0, 0, 0, 0, 0, 0, 0, 1],
    [55, 45, 4, 45, 55, 4, 46, 46, 56, 4, 47, 47, 37],
    [35, 25, 25, 25, 35, 26, 26, 26, 36, 27, 27, 27, 37],
    [35, 25, 25, 25, 35, 26, 26, 26, 36, 27, 27, 27, 37],
    [35, 25, 25, 25, 35, 26, 26, 26, 36, 27, 27, 27, 37],
    [45, 45, 45, 45, 45, 46, 46, 46, 46, 47, 47, 47, 0]
  ],
  "initialPosition": [15, 1],
  "initialDirection": 0.0,
  "rooms": ["C301", "C302", "C304", "C306", "C308", "C303", "C305", "C310"],
  "lift":["Floor C1*file-1701015463204-979820169.json","Floor C2*file-1701015646407-715764044.json","Floor C4*file-1701015706446-322119394.json"],
  "passages":["file-1701015416149-8227883.json","file-1701015781560-506564442.json"]
}
