{
  "groundTextureUrl": "./assets/textures/ground.jpg",
  "wallTextureUrl": "./assets/textures/wall.jpg",
  "doorTextureUrl": "./assets/textures/ground.jpg",
  "elevatorTextureUrl": "./assets/textures/ground.jpg",
  "size": { "width": 12, "height": 20 },
  "map": [
    [3, 2, 3, 2, 2, 2, 2, 2, 2, 11, 2, 2, 1],
    [1, 0, 6, 0, 0, 0, 0, 0, 0, 0, 0, 0, 9],
    [3, 2, 2, 2, 1, 0, 0, 0, 3, 2, 2, 2, 1],
    [1, 0, 0, 0, 1, 0, 0, 0, 1, 0, 0, 0, 1],
    [1, 0, 0, 0, 1, 0, 0, 0, 1, 0, 0, 0, 1],
    [1, 0, 0, 0, 1, 0, 0, 0, 1, 0, 0, 0, 1],
    [1, 0, 0, 0, 1, 0, 0, 0, 1, 0, 0, 0, 1],
    [1, 0, 0, 0, 5, 0, 0, 0, 5, 0, 0, 0, 1],
    [1, 0, 0, 0, 1, 0, 0, 0, 1, 0, 0, 0, 1],
    [3, 2, 2, 2, 1, 0, 0, 0, 3, 2, 2, 2, 1],
    [1, 0, 0, 0, 5, 0, 0, 0, 5, 0, 0, 0, 1],
    [1, 0, 0, 0, 1, 0, 0, 0, 1, 0, 0, 0, 1],
    [1, 0, 0, 0, 1, 0, 0, 0, 1, 0, 0, 0, 1],
    [1, 0, 0, 0, 1, 0, 0, 0, 1, 0, 0, 0, 1],
    [1, 0, 0, 0, 1, 0, 0, 0, 1, 0, 0, 0, 1],
    [1, 0, 0, 0, 1, 0, 0, 0, 1, 0, 0, 0, 1],
    [3, 2, 2, 2, 2, 2, 4, 2, 2, 2, 2, 2, 1],
    [1, 0, 0, 0, 0, 0, 0, 0, 0, 0, 0, 0, 1],
    [1, 0, 0, 0, 0, 0, 0, 0, 0, 0, 0, 0, 1],
    [1, 0, 0, 0, 0, 0, 0, 0, 0, 0, 0, 0, 1],
    [2, 2, 2, 2, 2, 2, 2, 2, 2, 2, 2, 2, 0]
  ],
  "initialPosition": [1, 11],
  "initialDirection": 0.0,
  "floor": "D3",
  "lift":["Floor D1*file-1701015826174-239516367.json","Floor D2*file-1701015757155-329601251.json"],
  "passages":["file-1701015416149-8227883.json","file-1701015679356-718589422.json"]
}
