{
  "groundTextureUrl": "./assets/textures/ground.jpg",
  "wallTextureUrl": "./assets/textures/wall.jpg",
  "doorTextureUrl": "./assets/textures/ground.jpg",
  "elevatorTextureUrl": "./assets/textures/ground.jpg",
  "size": { "width": 12, "height": 20 },
  "map": [
    [50, 40, 40, 40, 50, 2, 51, 41, 41, 41, 41, 41, 31],
    [30, 20, 20, 20, 5, 0, 31, 21, 21, 21, 21, 21, 31],
    [30, 20, 20, 20, 30, 0, 31, 21, 21, 21, 21, 21, 31],
    [30, 20, 20, 20, 30, 0, 31, 21, 21, 21, 21, 21, 31],
    [50, 40, 40, 40, 30, 0, 41, 4, 41, 41, 41, 41, 31],
    [32, 22, 22, 22, 5, 0, 0, 0, 0, 0, 0, 0, 1],
    [32, 22, 22, 22, 54, 44, 44, 44, 44, 44, 34, 0, 1],
    [32, 22, 22, 22, 34, 24, 24, 24, 24, 24, 34, 0, 1],
    [52, 42, 42, 42, 34, 24, 24, 24, 24, 24, 34, 0, 1],
    [33, 23, 23, 23, 34, 24, 24, 24, 24, 24, 34, 0, 1],
    [33, 23, 23, 23, 44, 44, 44, 44, 4, 44, 0, 0, 1],
    [33, 23, 23, 5, 33, 0, 0, 0, 0, 0, 0, 0, 1],
    [53, 43, 53, 43, 0, 0, 0, 0, 57, 4, 47, 47, 37],
    [1, 0, 6, 0, 0, 0, 0, 0, 37, 27, 27, 27, 37],
    [3, 2, 0, 0, 56, 46, 4, 46, 36, 27, 27, 27, 37],
    [8, 0, 0, 0, 36, 26, 26, 26, 36, 27, 27, 27, 37],
    [3, 45, 4, 45, 35, 26, 26, 26, 36, 27, 27, 27, 37],
    [35, 25, 25, 25, 35, 26, 26, 26, 36, 27, 27, 27, 37],
    [35, 25, 25, 25, 35, 26, 26, 26, 36, 27, 27, 27, 37],
    [35, 25, 25, 25, 35, 26, 26, 26, 36, 27, 27, 27, 37],
    [45, 45, 45, 45, 45, 46, 46, 46, 46, 47, 47, 47, 0]
  ],
  "initialPosition": [15, 0],
  "initialDirection": 0.0,
  "rooms": ["C201", "C202", "C203", "C207", "C209", "C205", "C204", "C206"],
  "lift":["Floor C1*file-1701015463204-979820169.json","Floor C3*file-1701015679356-718589422.json","Floor C4*file-1701015706446-322119394.json"],
  "passages":["file-1701015757155-329601251.json"]
}
