{
  "groundTextureUrl": "./assets/textures/ground.jpg",
  "wallTextureUrl": "./assets/textures/wall.jpg",
  "doorTextureUrl": "./assets/textures/ground.jpg",
  "elevatorTextureUrl": "./assets/textures/ground.jpg",
  "size": { "width": 12, "height": 20 },
  "map": [
    [3, 2, 3, 2, 2, 2, 2, 2, 2, 2, 2, 2, 1],
    [1, 0, 6, 0, 0, 0, 0, 0, 0, 0, 0, 0, 8],
    [50, 40, 40, 30, 0, 0, 0, 51, 41, 41, 41, 41, 31],
    [30, 20, 20, 5, 0, 0, 0, 31, 21, 21, 21, 21, 31],
    [30, 20, 20, 30, 0, 0, 0, 31, 21, 21, 21, 21, 31],
    [50, 40, 40, 30, 0, 0, 0, 31, 21, 21, 21, 21, 31],
    [32, 23, 23, 32, 0, 0, 0, 31, 21, 21, 21, 21, 31],
    [32, 23, 23, 32, 0, 0, 0, 31, 21, 21, 21, 21, 31],
    [32, 23, 23, 32, 0, 0, 0, 31, 21, 21, 21, 21, 31],
    [32, 23, 23, 5, 0, 0, 0, 5, 21, 21, 21, 21, 31],
    [32, 23, 23, 32, 0, 0, 0, 31, 21, 21, 21, 21, 31],
    [32, 23, 23, 32, 0, 0, 0, 31, 21, 21, 21, 21, 31],
    [52, 42, 42, 32, 0, 0, 0, 41, 51, 41, 41, 41, 31],
    [33, 23, 23, 33, 0, 0, 0, 0, 34, 24, 24, 24, 34],
    [33, 23, 23, 5, 0, 0, 0, 0, 5, 24, 24, 24, 34],
    [33, 23, 23, 33, 0, 0, 0, 0, 34, 24, 24, 24, 34],
    [33, 23, 23, 33, 0, 0, 0, 0, 34, 24, 24, 24, 34],
    [33, 23, 23, 53, 45, 4, 45, 45, 44, 44, 44, 44, 34],
    [33, 23, 23, 33, 25, 25, 25, 25, 25, 25, 25, 25, 35],
    [33, 23, 23, 33, 25, 25, 25, 25, 25, 25, 25, 25, 35],
    [43, 43, 43, 43, 45, 45, 45, 45, 45, 45, 45, 45, 0]
  ],
  "initialPosition": [1, 11],
  "initialDirection": 0.0,
  "rooms": ["D201", "D202", "D203", "D205", "D204", "D206"],
  "lift":["Floor D1*file-1701015826174-239516367.json","Floor D3*file-1701015781560-506564442.json"],
  "passages":["file-1701015646407-715764044.json"]
}
