{
  "groundTextureUrl": "./assets/textures/ground.jpg",
  "wallTextureUrl": "./assets/textures/wall.jpg",
  "doorTextureUrl": "./assets/textures/ground.jpg",
  "elevatorTextureUrl": "./assets/textures/ground.jpg",
  "size": { "width": 12, "height": 20 },
  "map": [
    [3, 2, 3, 2, 2, 2, 2, 2, 2, 2, 2, 2, 1],
    [1, 0, 6, 0, 0, 0, 0, 0, 0, 0, 0, 0, 8],
    [3, 2, 2, 1, 0, 0, 0, 3, 2, 2, 2, 2, 1],
    [1, 0, 0, 5, 0, 0, 0, 1, 0, 0, 0, 0, 1],
    [1, 0, 0, 1, 0, 0, 0, 1, 0, 0, 0, 0, 1],
    [3, 2, 2, 1, 0, 0, 0, 1, 0, 0, 0, 0, 1],
    [1, 0, 0, 1, 0, 0, 0, 1, 0, 0, 0, 0, 1],
    [1, 0, 0, 1, 0, 0, 0, 1, 0, 0, 0, 0, 1],
    [1, 0, 0, 1, 0, 0, 0, 1, 0, 0, 0, 0, 1],
    [1, 0, 0, 5, 0, 0, 0, 5, 0, 0, 0, 0, 1],
    [1, 0, 0, 1, 0, 0, 0, 1, 0, 0, 0, 0, 1],
    [1, 0, 0, 1, 0, 0, 0, 1, 0, 0, 0, 0, 1],
    [3, 2, 2, 1, 0, 0, 0, 2, 3, 2, 2, 2, 1],
    [1, 0, 0, 1, 0, 0, 0, 0, 1, 0, 0, 0, 1],
    [1, 0, 0, 5, 0, 0, 0, 0, 5, 0, 0, 0, 1],
    [1, 0, 0, 1, 0, 0, 0, 0, 1, 0, 0, 0, 1],
    [1, 0, 0, 1, 0, 0, 0, 0, 1, 0, 0, 0, 1],
    [1, 0, 0, 3, 2, 4, 2, 2, 2, 2, 2, 2, 1],
    [1, 0, 0, 1, 0, 0, 0, 0, 0, 0, 0, 0, 1],
    [1, 0, 0, 1, 0, 0, 0, 0, 0, 0, 0, 0, 1],
    [2, 2, 2, 2, 2, 2, 2, 2, 2, 2, 2, 2, 0]
  ],
  "initialPosition": [1, 11],
  "initialDirection": 0.0,
  "floor": "D2",
  "lift":["Floor D1*file-1701015826174-239516367.json","Floor D3*file-1701015781560-506564442.json"],
  "passages":["file-1701015646407-715764044.json"]
}
