{
  "groundTextureUrl": "./assets/textures/ground.jpg",
  "wallTextureUrl": "./assets/textures/wall.jpg",
  "doorTextureUrl": "./assets/textures/ground.jpg",
  "elevatorTextureUrl": "./assets/textures/ground.jpg",
  "size": { "width": 22, "height": 10 },
  "map": [
    [50, 40, 40, 40, 50, 42, 42, 42, 42, 42, 42, 52, 44, 44, 44, 44, 44, 44, 54, 46, 46, 46, 36],
    [30, 20, 20, 20, 30, 22, 22, 22, 22, 22, 22, 32, 24, 24, 24, 24, 24, 24, 34, 26, 26, 26, 36],
    [30, 20, 20, 20, 30, 22, 22, 22, 22, 22, 22, 32, 24, 24, 24, 24, 24, 24, 34, 26, 26, 26, 36],
    [30, 20, 20, 20, 30, 22, 22, 22, 22, 22, 22, 32, 24, 24, 24, 24, 24, 24, 34, 26, 26, 26, 36],
    [50, 40, 4, 40, 40, 4, 42, 42, 42, 42, 42, 42, 4, 44, 44, 44, 44, 44, 44, 4, 46, 46, 36],
    [1, 0, 0, 0, 0, 0, 0, 0, 0, 0, 0, 0, 0, 0, 0, 0, 0, 0, 0, 0, 0, 0, 1],
    [3, 41, 4, 41, 31, 0, 53, 43, 43, 43, 53, 45, 45, 45, 45, 45, 4, 45, 35, 0, 3, 7, 1],
    [31, 21, 21, 21, 31, 0, 33, 23, 23, 23, 33, 25, 25, 25, 25, 25, 25, 25, 35, 0, 1, 0, 1],
    [31, 21, 21, 21, 31, 0, 5, 23, 23, 23, 33, 25, 25, 25, 25, 25, 25, 25, 55, 4, 47, 47, 37],
    [31, 21, 21, 21, 31, 0, 33, 23, 23, 23, 33, 25, 25, 25, 25, 25, 25, 25, 35, 27, 27, 27, 37],
    [41, 41, 41, 41, 41, 2, 43, 43, 43, 43, 43, 45, 45, 45, 45, 45, 45, 45, 45, 47, 47, 47, 27]
  ],
  "initialPosition": [5, 21],
  "initialDirection": 0.0,
  "rooms": ["B101", "B102", "B103", "B104", "B105", "B106", "B107", "B106B"],
  "lift":["Floor B2*file-1701015416149-8227883.json","Floor B3*file-1701015442314-712983611.json"],
  "passages":[]
}
