{
  "groundTextureUrl": "./assets/textures/ground.jpg",
  "wallTextureUrl": "./assets/textures/wall.jpg",
  "doorTextureUrl": "./assets/textures/ground.jpg",
  "elevatorTextureUrl": "./assets/textures/ground.jpg",
  "size": { "width": 22, "height": 10 },
  "map": [
    [50, 40, 40, 40, 50, 42, 42, 42, 52, 44, 44, 44, 54, 46, 46, 46, 56, 48, 48, 48, 58, 2, 1],
    [30, 20, 20, 20, 30, 22, 22, 22, 32, 24, 24, 24, 34, 26, 26, 26, 36, 28, 28, 28, 38, 0, 1],
    [30, 20, 20, 20, 30, 22, 22, 22, 32, 24, 24, 24, 34, 26, 26, 26, 56, 4, 48, 48, 48, 7, 1],
    [30, 20, 20, 20, 30, 22, 22, 22, 32, 24, 24, 24, 34, 26, 26, 26, 36, 0, 0, 0, 0, 0, 1],
    [30, 20, 20, 20, 50, 42, 4, 42, 42, 44, 4, 44, 44, 4, 46, 46, 0, 0, 0, 0, 0, 0, 1],
    [30, 20, 20, 20, 5, 0, 0, 0, 0, 0, 0, 0, 0, 0, 0, 0, 0, 0, 0, 0, 0, 0, 8],
    [50, 40, 40, 40, 40, 41, 4, 41, 41, 51, 4, 43, 43, 53, 4, 45, 45, 35, 0, 0, 0, 0, 1],
    [31, 21, 21, 21, 21, 21, 21, 21, 21, 31, 23, 23, 23, 33, 25, 25, 25, 35, 0, 0, 0, 0, 1],
    [31, 21, 21, 21, 21, 21, 21, 21, 21, 31, 23, 23, 23, 33, 25, 25, 25, 55, 4, 47, 47, 47, 37],
    [31, 21, 21, 21, 21, 21, 21, 21, 21, 31, 23, 23, 23, 33, 25, 25, 25, 35, 27, 27, 27, 27, 37],
    [41, 41, 41, 41, 41, 41, 41, 41, 41, 41, 43, 43, 43, 43, 45, 45, 45, 45, 47, 47, 47, 47, 27]
  ],
  "initialPosition": [3, 21],
  "initialDirection": 0.0,
  "rooms": ["A201", "A202", "A203", "A204", "A205", "A206", "A207", "A208", "A209"],
  "lift":["Floor A1*file-1701015326079-507903215.json"],
  "passages":["file-1701015416149-8227883.json"]
}
