{
  "groundTextureUrl": "./assets/textures/ground.jpg",
  "wallTextureUrl": "./assets/textures/wall.jpg",
  "doorTextureUrl": "./assets/textures/ground.jpg",
  "elevatorTextureUrl": "./assets/textures/ground.jpg",
  "size": { "width": 22, "height": 10 },
  "map": [
    [50, 40, 40, 40, 50, 2, 51, 41, 41, 41, 51, 2, 53, 43, 43, 43, 43, 43, 43, 43, 43, 43, 1],
    [30, 20, 20, 20, 5, 0, 5, 21, 21, 21, 31, 0, 5, 0, 23, 23, 23, 23, 23, 23, 23, 23, 33],
    [30, 20, 20, 20, 30, 0, 31, 21, 21, 21, 31, 0, 33, 23, 23, 23, 23, 23, 23, 23, 23, 23, 33],
    [30, 20, 20, 20, 30, 0, 31, 21, 21, 21, 31, 0, 33, 23, 23, 23, 23, 23, 23, 23, 23, 23, 33],
    [30, 20, 20, 20, 30, 0, 31, 21, 21, 21, 31, 0, 33, 23, 23, 23, 23, 23, 23, 23, 23, 23, 33],
    [30, 20, 20, 20, 30, 0, 31, 21, 21, 21, 31, 0, 33, 23, 23, 23, 23, 23, 23, 23, 23, 23, 33],
    [30, 20, 20, 20, 30, 0, 31, 21, 21, 21, 31, 0, 43, 43, 43, 43, 43, 43, 43, 43, 53, 2, 1],
    [30, 20, 20, 20, 30, 0, 31, 21, 21, 21, 31, 0, 52, 4, 42, 42, 42, 42, 32, 0, 1, 0, 1],
    [30, 20, 20, 20, 30, 0, 41, 41, 41, 41, 0, 0, 32, 22, 22, 22, 22, 22, 32, 0, 2, 7, 1],
    [30, 20, 20, 20, 30, 0, 0, 0, 0, 0, 0, 0, 32, 22, 22, 22, 22, 22, 32, 0, 0, 0, 8],
    [40, 40, 40, 40, 40, 2, 2, 2, 2, 2, 2, 2, 42, 42, 42, 42, 42, 42, 42, 2, 2, 2, 0]
  ],
  "initialPosition": [9, 21],
  "initialDirection": 0.0,
  "rooms": ["B301", "B303", "B302", "B305"],
  "lift":["Floor B1*file-1701015393418-693397401.json","Floor B2*file-1701015416149-8227883.json"],
  "passages":["file-1701015706446-322119394.json"]
}
