{
  "groundTextureUrl": "./assets/textures/ground.jpg",
  "wallTextureUrl": "./assets/textures/wall.jpg",
  "doorTextureUrl": "./assets/textures/ground.jpg",
  "elevatorTextureUrl": "./assets/textures/ground.jpg",
  "size": { "width": 12, "height": 20 },
  "map": [
    [50, 40, 40, 40, 40, 40, 50, 41, 41, 41, 41, 41, 31],
    [30, 20, 20, 20, 20, 20, 30, 21, 21, 21, 21, 21, 31],
    [30, 20, 20, 20, 20, 20, 30, 21, 21, 21, 21, 21, 31],
    [30, 20, 20, 20, 20, 20, 30, 21, 21, 21, 21, 21, 31],
    [30, 20, 20, 20, 20, 20, 30, 21, 21, 21, 21, 21, 31],
    [30, 20, 20, 20, 20, 20, 30, 21, 21, 21, 21, 21, 31],
    [30, 20, 20, 20, 20, 20, 40, 41, 41, 41, 4, 41, 31],
    [30, 20, 20, 20, 20, 5, 30, 0, 0, 0, 0, 0, 1],
    [50, 40, 40, 40, 40, 40, 0, 0, 52, 42, 42, 42, 32],
    [8, 0, 0, 0, 0, 0, 0, 0, 32, 22, 22, 22, 32],
    [1, 0, 0, 0, 0, 0, 0, 0, 32, 22, 22, 22, 32],
    [1, 0, 0, 0, 0, 0, 0, 0, 32, 22, 22, 22, 32],
    [3, 2, 6, 0, 0, 0, 0, 0, 42, 42, 4, 42, 32],
    [1, 0, 1, 0, 0, 0, 0, 0, 0, 0, 0, 0, 1],
    [53, 43, 43, 43, 43, 43, 4, 43, 43, 43, 43, 43, 33],
    [33, 23, 23, 23, 23, 23, 23, 23, 23, 23, 23, 23, 33],
    [33, 23, 23, 23, 23, 23, 23, 23, 23, 23, 23, 23, 33],
    [33, 23, 23, 23, 23, 23, 23, 23, 23, 23, 23, 23, 33],
    [33, 23, 23, 23, 23, 23, 23, 23, 23, 23, 23, 23, 33],
    [33, 23, 23, 23, 23, 23, 23, 23, 23, 23, 23, 23, 33],
    [43, 43, 43, 43, 43, 43, 43, 43, 43, 43, 43, 43, 0]
  ],
  "initialPosition": [9, 1],
  "initialDirection": 0.0,
  "rooms": ["C401", "C402", "C404", "C403"],
  "lift":["Floor C1*file-1701015463204-979820169.json","Floor C2*file-1701015646407-715764044.json","Floor C3*file-1701015679356-718589422.json"],
  "passages":["file-1701015442314-712983611.json"]
}
