{
  "groundTextureUrl": "./assets/textures/ground.jpg",
  "wallTextureUrl": "./assets/textures/wall.jpg",
  "doorTextureUrl": "./assets/textures/ground.jpg",
  "elevatorTextureUrl": "./assets/textures/ground.jpg",
  "size": { "width": 12, "height": 20 },
  "map": [
    [50, 40, 40, 40, 40, 40, 50, 2, 51, 41, 41, 41, 31],
    [30, 20, 20, 20, 20, 20, 30, 0, 31, 21, 21, 21, 31],
    [30, 20, 20, 20, 20, 20, 5, 0, 5, 21, 21, 21, 31],
    [30, 20, 20, 20, 20, 20, 30, 0, 31, 21, 21, 21, 31],
    [50, 40, 40, 40, 40, 40, 30, 0, 51, 41, 41, 41, 31],
    [32, 22, 22, 22, 22, 22, 32, 0, 33, 23, 23, 23, 33],
    [32, 22, 22, 22, 22, 22, 5, 0, 5, 23, 23, 23, 33],
    [32, 22, 22, 22, 22, 22, 32, 0, 33, 23, 23, 23, 33],
    [52, 42, 42, 42, 42, 42, 0, 0, 53, 43, 43, 43, 33],
    [1, 0, 0, 0, 0, 0, 0, 0, 34, 24, 24, 24, 34],
    [1, 0, 0, 0, 0, 0, 0, 0, 5, 24, 24, 24, 34],
    [1, 0, 0, 0, 0, 0, 0, 0, 34, 24, 24, 24, 34],
    [3, 2, 1, 0, 0, 0, 0, 0, 54, 44, 44, 44, 34],
    [1, 0, 6, 0, 0, 0, 0, 0, 35, 25, 25, 25, 35],
    [3, 2, 0, 0, 0, 0, 0, 0, 5, 25, 25, 25, 35],
    [1, 0, 0, 0, 0, 0, 0, 0, 35, 25, 25, 25, 35],
    [57, 47, 47, 47, 47, 47, 37, 0, 55, 45, 45, 45, 35],
    [37, 27, 27, 27, 27, 27, 37, 0, 36, 26, 26, 26, 36],
    [37, 27, 27, 27, 27, 27, 5, 0, 5, 26, 26, 26, 36],
    [37, 27, 27, 27, 27, 27, 37, 0, 36, 26, 26, 26, 36],
    [47, 47, 47, 47, 47, 47, 47, 2, 46, 46, 46, 46, 0]
  ],
  "initialPosition": [13, 3],
  "initialDirection": 0.0,
  "rooms": ["C101", "C102", "C103", "C104", "C106", "C108", "C110", "C105"],
  "lift":["Floor C2*file-1701015646407-715764044.json","Floor C3*file-1701015679356-718589422.json","Floor C4*file-1701015706446-322119394.json"],
  "passages":[]
}
