{
  "groundTextureUrl": "./assets/textures/ground.jpg",
  "wallTextureUrl": "./assets/textures/wall.jpg",
  "doorTextureUrl": "./assets/textures/ground.jpg",
  "elevatorTextureUrl": "./assets/textures/ground.jpg",
  "size": { "width": 22, "height": 10 },
  "map": [
    [3, 2, 3, 2, 2, 2, 3, 2, 2, 2, 2, 2, 2, 2, 3, 2, 2, 2, 3, 2, 2, 2, 1],
    [1, 0, 1, 0, 0, 0, 1, 0, 0, 0, 0, 0, 0, 0, 1, 0, 0, 0, 1, 0, 0, 0, 1],
    [1, 0, 1, 0, 0, 0, 1, 0, 3, 2, 2, 2, 1, 0, 1, 0, 0, 0, 1, 0, 0, 0, 1],
    [1, 0, 1, 0, 0, 0, 1, 0, 1, 0, 0, 0, 1, 0, 1, 0, 0, 0, 1, 0, 0, 0, 1],
    [3, 2, 1, 0, 0, 0, 1, 0, 1, 0, 0, 0, 5, 0, 1, 0, 0, 0, 3, 4, 2, 2, 1],
    [8, 0, 1, 0, 0, 0, 1, 0, 1, 0, 0, 0, 1, 0, 1, 0, 0, 0, 1, 0, 0, 0, 1],
    [1, 0, 1, 0, 0, 0, 5, 0, 1, 0, 0, 0, 1, 0, 1, 0, 0, 0, 5, 0, 3, 2, 1],
    [1, 0, 1, 0, 0, 0, 1, 0, 1, 0, 0, 0, 1, 0, 1, 0, 0, 0, 1, 0, 1, 0, 1],
    [1, 0, 2, 2, 2, 2, 0, 0, 1, 0, 0, 0, 1, 0, 2, 2, 2, 2, 0, 0, 2, 7, 1],
    [1, 0, 0, 0, 0, 0, 0, 0, 1, 0, 0, 0, 1, 0, 0, 0, 0, 0, 0, 0, 0, 0, 9],
    [2, 2, 2, 2, 2, 2, 2, 2, 2, 2, 2, 2, 2, 2, 2, 2, 2, 2, 2, 2, 2, 13, 0]
  ],
  "initialPosition": [5, 3],
  "initialDirection": 0.0,
  "floor": "B2",
  "lift":["file-1701015393418-693397401.json","file-1701015442314-712983611.json"],
  "passages":["file-1701015354579-810026028.json","file-1701015679356-718589422.json","file-1701015781560-506564442.json"]
}
