{
  "groundTextureUrl": "./assets/textures/ground.jpg",
  "wallTextureUrl": "./assets/textures/wall.jpg",
  "doorTextureUrl": "./assets/textures/ground.jpg",
  "elevatorTextureUrl": "./assets/textures/ground.jpg",
  "size": { "width": 22, "height": 10 },
  "map": [
    [3, 2, 2, 2, 3, 2, 2, 2, 2, 2, 2, 3, 2, 2, 2, 2, 2, 2, 3, 2, 2, 2, 1],
    [1, 0, 0, 0, 1, 0, 0, 0, 0, 0, 0, 1, 0, 0, 0, 0, 0, 0, 1, 0, 0, 0, 1],
    [1, 0, 0, 0, 1, 0, 0, 0, 0, 0, 0, 1, 0, 0, 0, 0, 0, 0, 1, 0, 0, 0, 1],
    [1, 0, 0, 0, 1, 0, 0, 0, 0, 0, 0, 1, 0, 0, 0, 0, 0, 0, 1, 0, 0, 0, 1],
    [3, 2, 4, 2, 2, 4, 2, 2, 2, 2, 2, 2, 4, 2, 2, 2, 2, 2, 2, 4, 2, 2, 1],
    [1, 0, 0, 0, 0, 0, 0, 0, 0, 0, 0, 0, 0, 0, 0, 0, 0, 0, 0, 0, 0, 0, 1],
    [3, 2, 4, 2, 1, 0, 3, 2, 2, 2, 3, 2, 2, 2, 2, 2, 4, 2, 1, 0, 3, 7, 1],
    [1, 0, 0, 0, 1, 0, 1, 0, 0, 0, 1, 0, 0, 0, 0, 0, 0, 0, 1, 0, 1, 0, 1],
    [1, 0, 0, 0, 1, 0, 5, 0, 0, 0, 1, 0, 0, 0, 0, 0, 0, 0, 3, 4, 2, 2, 1],
    [1, 0, 0, 0, 1, 0, 1, 0, 0, 0, 1, 0, 0, 0, 0, 0, 0, 0, 1, 0, 0, 0, 1],
    [2, 2, 2, 2, 2, 2, 2, 2, 2, 2, 2, 2, 2, 2, 2, 2, 2, 2, 2, 2, 2, 2, 0]
  ],
  "initialPosition": [5, 21],
  "initialDirection": 0.0,
  "floor": "B1",
  "lift":["Floor B2*file-1701015416149-8227883.json","Floor B3*file-1701015442314-712983611.json"],
  "passages":[]
}
