{
  "groundTextureUrl": "./assets/textures/ground.jpg",
  "wallTextureUrl": "./assets/textures/wall.jpg",
  "doorTextureUrl": "./assets/textures/ground.jpg",
  "elevatorTextureUrl": "./assets/textures/ground.jpg",
  "size": { "width": 22, "height": 10 },
  "map": [
    [50, 40, 50, 41, 41, 41, 51, 2, 2, 2, 2, 2, 2, 2, 53, 43, 43, 43, 53, 44, 44, 44, 34],
    [30, 20, 30, 21, 21, 21, 31, 0, 0, 0, 0, 0, 0, 0, 33, 23, 23, 23, 33, 24, 24, 24, 34],
    [30, 20, 30, 21, 21, 21, 31, 0, 52, 42, 42, 42, 32, 0, 33, 23, 23, 23, 33, 24, 24, 24, 34],
    [30, 20, 30, 21, 21, 21, 31, 0, 32, 22, 22, 22, 32, 0, 33, 23, 23, 23, 33, 24, 24, 24, 34],
    [50, 40, 30, 21, 21, 21, 31, 0, 32, 22, 22, 22, 5, 0, 33, 23, 23, 23, 54, 4, 44, 44, 34],
    [8, 0, 31, 21, 21, 21, 31, 0, 32, 22, 22, 22, 32, 0, 33, 23, 23, 23, 33, 0, 0, 0, 1],
    [1, 0, 31, 21, 21, 21, 5, 0, 32, 22, 22, 22, 32, 0, 33, 23, 23, 23, 5, 0, 3, 2, 1],
    [1, 0, 31, 21, 21, 21, 31, 0, 32, 22, 22, 22, 32, 0, 33, 23, 23, 23, 33, 0, 1, 0, 1],
    [1, 0, 41, 41, 41, 41, 0, 0, 32, 22, 22, 22, 32, 0, 43, 43, 43, 43, 0, 0, 2, 7, 1],
    [1, 0, 0, 0, 0, 0, 0, 0, 32, 22, 22, 22, 32, 0, 0, 0, 0, 0, 0, 0, 0, 0, 9],
    [2, 2, 2, 2, 2, 2, 2, 2, 42, 42, 42, 42, 42, 2, 2, 2, 2, 2, 2, 2, 2, 2, 0]
  ],
  "initialPosition": [9, 21],
  "initialDirection": 0.0,
  "rooms": ["B201", "B203", "B202", "B205", "B207"],
  "lift":["Floor B1*file-1701015393418-693397401.json","Floor B3*file-1701015442314-712983611.json"],
  "passages":["file-1701015354579-810026028.json","file-1701015679356-718589422.json","file-1701015781560-506564442.json"]
}
