{
  "groundTextureUrl": "./assets/textures/ground.jpg",
  "wallTextureUrl": "./assets/textures/wall.jpg",
  "doorTextureUrl": "./assets/textures/ground.jpg",
  "elevatorTextureUrl": "./assets/textures/ground.jpg",
  "size": { "width": 12, "height": 20 },
  "map": [
    [3, 2, 3, 2, 2, 2, 2, 2, 2, 11, 2, 2, 1],
    [1, 0, 6, 0, 0, 0, 0, 0, 0, 0, 0, 0, 9],
    [50, 40, 40, 40, 30, 0, 0, 0, 52, 42, 42, 42, 32],
    [30, 20, 20, 20, 30, 0, 0, 0, 32, 22, 22, 22, 32],
    [30, 20, 20, 20, 30, 0, 0, 0, 32, 22, 22, 22, 32],
    [30, 20, 20, 20, 30, 0, 0, 0, 32, 22, 22, 22, 32],
    [30, 20, 20, 20, 30, 0, 0, 0, 32, 22, 22, 22, 32],
    [30, 20, 20, 20, 5, 0, 0, 0, 5, 22, 22, 22, 32],
    [30, 20, 20, 20, 30, 0, 0, 0, 32, 22, 22, 22, 32],
    [50, 40, 40, 40, 30, 0, 0, 0, 52, 42, 42, 42, 32],
    [31, 21, 21, 21, 5, 0, 0, 0, 5, 23, 23, 23, 33],
    [31, 21, 21, 21, 31, 0, 0, 0, 33, 23, 23, 23, 33],
    [31, 21, 21, 21, 31, 0, 0, 0, 33, 23, 23, 23, 33],
    [31, 21, 21, 21, 31, 0, 0, 0, 33, 23, 23, 23, 33],
    [31, 21, 21, 21, 31, 0, 0, 0, 33, 23, 23, 23, 33],
    [31, 21, 21, 21, 31, 0, 0, 0, 33, 23, 23, 23, 33],
    [51, 41, 41, 41, 41, 44, 4, 44, 43, 43, 43, 43, 33],
    [34, 24, 24, 24, 24, 24, 24, 24, 24, 24, 24, 24, 34],
    [34, 24, 24, 24, 24, 24, 24, 24, 24, 24, 24, 24, 34],
    [34, 24, 24, 24, 24, 24, 24, 24, 24, 24, 24, 24, 34],
    [44, 44, 44, 44, 44, 44, 44, 44, 44, 44, 44, 44, 0]
  ],
  "initialPosition": [1, 11],
  "initialDirection": 0.0,
  "rooms": ["D301", "D303", "D302", "D304", "D305"],
  "lift":["Floor D1*file-1701015826174-239516367.json","Floor D2*file-1701015757155-329601251.json"],
  "passages":["file-1701015416149-8227883.json","file-1701015679356-718589422.json"]
}
