{
  "groundTextureUrl": "./assets/textures/ground.jpg",
  "wallTextureUrl": "./assets/textures/wall.jpg",
  "doorTextureUrl": "./assets/textures/ground.jpg",
  "elevatorTextureUrl": "./assets/textures/ground.jpg",
  "size": { "width": 22, "height": 10 },
  "map": [
    [55, 45, 45, 45, 45, 45, 45, 45, 45, 45, 55, 40, 40, 40, 50, 41, 41, 41, 51, 42, 52, 2, 1],
    [35, 25, 25, 25, 25, 25, 25, 25, 25, 25, 35, 20, 20, 20, 30, 21, 21, 21, 31, 22, 32, 0, 1],
    [35, 25, 25, 25, 25, 25, 25, 25, 25, 25, 55, 4, 40, 40, 40, 4, 41, 41, 41, 4, 42, 7, 1],
    [35, 25, 25, 25, 25, 25, 25, 25, 25, 25, 35, 0, 0, 0, 0, 0, 0, 0, 0, 0, 0, 0, 1],
    [35, 25, 25, 25, 25, 25, 25, 25, 25, 25, 5, 0, 0, 0, 0, 0, 0, 0, 0, 0, 0, 0, 1],
    [35, 25, 25, 25, 25, 25, 25, 25, 25, 25, 35, 0, 0, 0, 0, 0, 0, 0, 0, 0, 0, 0, 1],
    [35, 25, 25, 25, 25, 25, 25, 25, 25, 25, 35, 0, 0, 0, 0, 0, 0, 0, 0, 0, 0, 0, 1],
    [35, 25, 25, 25, 25, 25, 25, 25, 25, 25, 35, 0, 0, 0, 0, 0, 0, 0, 0, 0, 0, 0, 1],
    [35, 25, 25, 25, 25, 25, 25, 25, 25, 25, 55, 4, 43, 43, 33, 0, 0, 0, 54, 4, 44, 44, 34],
    [35, 25, 25, 25, 25, 25, 25, 25, 25, 25, 35, 23, 23, 23, 33, 0, 0, 0, 34, 24, 24, 24, 34],
    [45, 45, 45, 45, 45, 45, 45, 45, 45, 45, 45, 43, 43, 43, 43, 2, 2, 2, 44, 44, 44, 44, 0]
  ],
  "initialPosition": [3, 21],
  "initialDirection": 0.0,
  "rooms": ["Beng", "K1", "K2", "R1", "R2", "Auditório Prof Nunes"],
  "lift":["Floor A2*file-1701015354579-810026028.json"],
  "passages":[]
}