{
  "groundTextureUrl": "./assets/textures/ground.jpg",
  "wallTextureUrl": "./assets/textures/wall.jpg",
  "doorTextureUrl": "./assets/textures/ground.jpg",
  "elevatorTextureUrl": "./assets/textures/ground.jpg",
  "size": { "width": 12, "height": 20 },
  "map": [
    [3, 2, 2, 2, 2, 2, 3, 2, 2, 2, 2, 2, 1],
    [1, 0, 0, 0, 0, 0, 1, 0, 0, 0, 0, 0, 1],
    [1, 0, 0, 0, 0, 0, 1, 0, 0, 0, 0, 0, 1],
    [1, 0, 0, 0, 0, 0, 1, 0, 0, 0, 0, 0, 1],
    [1, 0, 0, 0, 0, 0, 1, 0, 0, 0, 0, 0, 1],
    [1, 0, 0, 0, 0, 0, 1, 0, 0, 0, 0, 0, 1],
    [1, 0, 0, 0, 0, 0, 2, 2, 2, 2, 4, 2, 1],
    [1, 0, 0, 0, 0, 0, 1, 0, 0, 0, 0, 0, 1],
    [3, 2, 2, 2, 2, 2, 0, 0, 3, 2, 2, 2, 1],
    [8, 0, 0, 0, 0, 0, 0, 0, 1, 0, 0, 0, 1],
    [1, 0, 0, 0, 0, 0, 0, 0, 1, 0, 0, 0, 1],
    [1, 0, 0, 0, 0, 0, 0, 0, 1, 0, 0, 0, 1],
    [3, 2, 6, 0, 0, 0, 0, 0, 2, 2, 4, 2, 1],
    [1, 0, 1, 0, 0, 0, 0, 0, 0, 0, 0, 0, 1],
    [3, 2, 2, 2, 2, 2, 4, 2, 2, 2, 2, 2, 1],
    [1, 0, 0, 0, 0, 0, 0, 0, 0, 0, 0, 0, 1],
    [1, 0, 0, 0, 0, 0, 0, 0, 0, 0, 0, 0, 1],
    [1, 0, 0, 0, 0, 0, 0, 0, 0, 0, 0, 0, 1],
    [1, 0, 0, 0, 0, 0, 0, 0, 0, 0, 0, 0, 1],
    [1, 0, 0, 0, 0, 0, 0, 0, 0, 0, 0, 0, 1],
    [2, 2, 2, 2, 2, 2, 2, 2, 2, 2, 2, 2, 0]
  ],
  "initialPosition": [9, 1],
  "initialDirection": 0.0,
  "floor": "C4",
  "lift":["Floor C1*file-1701015463204-979820169.json","Floor C2*file-1701015646407-715764044.json","Floor C3*file-1701015679356-718589422.json"],
  "passages":["file-1701015442314-712983611.json"]
}
